memory_initialization_radix=2;
memory_initialization_vector=
0000000000000000,
0000000000000001,
0000000000000010,
0000000000000011,
0000000000000100,
0000000000000101,
0000000000000110,
0000000000000111,
0000000000001000,
0000000000001001,
0000000000000000,
0000000000000001,
0000000000000010,
0000000000000011,
0000000000000100,
0000000000000101,
0000000000000110,
0000000000000111,
0000000000001000,
0000000000001001;